107
8
21 4 0 0 0 0 0 0 0 0 0 0 0 0 0 0 0 0 0 0 0 0 0 0 0 0 0 0 0 0 0 0 0 0 0 0 0 0 0 0 0 0 0 3 21 21 21 21 21 21 21 21 21 21 21 21 21 21 21 21 21 21 21 21 21 21 21 21 21 21 21 21 21 21 21 4 0 0 0 0 0 0 0 0 0 0 0 0 0 0 3 21 21 21 21 21 21 21 21 21 21 21 21 21 21 21 21
21 4 0 0 0 0 0 0 0 0 0 0 0 0 0 0 0 0 0 0 0 0 0 0 0 0 0 0 0 0 0 0 0 0 0 0 0 0 0 0 0 0 0 0 18 21 21 21 21 21 21 21 21 21 21 21 21 21 21 21 19 17 17 17 17 17 17 17 17 17 18 21 21 21 21 4 0 0 0 0 0 0 0 0 0 0 0 0 0 0 0 18 21 21 21 21 21 19 17 17 17 17 17 17 17 18 21
21 4 0 0 0 0 0 0 0 0 0 0 13 0 0 0 0 0 14 0 0 0 0 0 0 0 0 0 0 0 0 0 0 0 0 0 0 0 0 0 10 0 0 0 0 17 17 17 18 21 21 21 21 21 21 21 21 21 21 21 4 0 0 16 0 0 0 0 0 0 0 17 18 21 21 4 0 0 0 0 0 0 0 0 0 0 0 0 0 0 0 0 18 21 21 21 21 4 0 0 0 0 0 0 0 3 21
21 4 0 0 0 0 0 0 0 0 0 0 0 0 0 11 0 0 0 0 0 0 0 0 0 0 0 0 0 0 0 0 0 0 11 0 0 0 0 22 23 24 0 0 0 0 0 0 0 17 17 18 21 21 21 21 21 21 21 19 0 0 10 0 11 0 0 0 0 0 0 0 0 17 17 0 0 0 0 9 0 0 0 0 0 20 2 0 0 0 0 0 0 18 21 21 21 4 0 0 0 0 0 0 0 3 21
21 4 0 0 0 12 0 0 0 0 0 0 11 1 20 20 2 0 0 0 0 0 0 0 0 0 0 15 0 0 0 0 0 22 24 0 0 0 0 0 0 0 0 0 0 9 11 0 0 0 0 0 17 17 17 17 17 17 17 0 0 1 20 20 20 2 0 0 0 0 0 0 0 0 0 0 0 0 0 22 23 24 0 0 3 21 4 0 0 0 0 0 0 0 18 21 21 4 0 0 0 0 0 0 0 3 21
21 4 0 0 0 0 0 0 0 0 1 20 20 20 6 21 4 0 0 0 0 0 10 9 0 0 0 0 0 0 10 0 0 0 0 0 0 11 0 0 0 0 0 1 20 20 20 20 2 0 0 0 9 0 0 0 0 9 0 0 0 3 21 21 21 4 0 0 0 0 0 0 0 0 0 0 0 0 0 0 0 0 0 0 3 21 4 0 0 0 0 0 0 0 0 17 17 0 0 0 0 0 0 0 0 3 21
21 4 9 0 10 0 0 0 0 11 3 21 21 21 21 21 4 0 0 0 1 20 20 20 20 2 0 0 10 1 20 20 2 0 10 1 20 20 2 0 0 0 0 3 21 21 21 21 4 10 0 1 20 2 0 0 1 20 2 11 1 20 6 21 21 4 0 0 0 0 0 0 0 10 0 0 11 10 0 0 11 0 0 0 20 5 20 2 0 0 0 0 0 0 0 0 0 0 0 11 11 0 0 10 0 3 21
5 20 20 20 20 20 20 20 20 20 20 6 21 21 21 21 4 0 0 0 3 21 21 21 21 20 20 20 20 20 6 5 20 20 20 20 6 21 4 0 0 0 0 3 21 21 21 5 20 20 20 20 20 20 20 20 20 20 20 20 20 6 21 21 21 4 0 0 0 0 0 0 20 20 20 20 20 20 20 20 20 20 20 20 6 21 5 20 20 20 20 20 20 20 20 20 20 20 20 20 20 20 20 20 20 20 6
